000000200200111
000000000200111
000000000200111
200000000200000
000000000220000
000000000200000
000222222000000
000000000000002
000000000000000
000000000000000
200000000220000
000000000200000
000000000200000
000000000022200
000000000200000
000000000200000
000200000200000
111020000000000
111002000000000
111000000000000
