000000020000111
000000000000111
000000000000111
222200000000000
000200020000000
000000020000000
000000020000000
000000020000000
000000020022000
002000020000222
002000000000000
002000000000000
000000000000000
000000000222222
000000000000000
000020000000000
000002000000000
111000200000000
111000020000000
111000000000000
