000000000000111
000000000000111
000000000000111
000000000000000
000000000000000
000000000000000
000000000000000
000022222000000
000022000000000
000000000000000
000000000000000
000000000000000
000000000000000
000000020000000
000000000000000
000000000000000
000000000000000
111000000000000
111000000000000
111000000000000
