111111211211111
111111211111111
111111111111111
111111111111111
222111111111112
111111111111111
111111111111111
111111222222111
111111222222111
111111111111111
122111111111111
121111111111111
111111111122211
111111111111211
111111221111111
111111211111111
111111211111111
111111111111111
111111111111111
111111111111111
