000000000200111
020000000000111
000000000000111
000002000000000
000000000222000
000200000000000
000200000000000
000200000000000
000200000000000
000200000002000
000200000002000
000000000002000
000000000002000
000000000002000
000000000002000
000222000000000
000000000200000
111000000000000
111000000000020
111002000000000
