000000000000111
000020000000111
000000000000111
000000020000000
000000000000000
000000000000020
000000000000000
000022222200000
000022222200000
000000000000000
000000000000000
000000000000000
222000000000000
000000000000000
000000002000000
000000002000000
000000002000000
111000000000200
111000000000000
111000000000000
