000002000000111
000002000000111
000002000000111
000000000000000
000000000000000
000000000000222
000000000000000
000200000000000
000000002000000
000000000200000
000000000000000
000000000000000
000000000000000
222222000002000
000000000000000
000000000000000
000000000000000
111000000200000
111000000200000
111000000200000
