000000000000111
000000000000111
000000020000111
000000000000000
000000000000000
000000000002220
222222000000000
000000000000000
000000000000000
000000000020000
000000000000000
000002220000000
000000000000000
000000000000000
020000000000000
000000000002220
000000000000000
111000020000000
111000000000000
111000000000000
