000000002000111
000000000000111
000000000000111
000020000000000
000020000000000
000020000222222
000000000000000
000000000000000
000000000000000
020000220000000
000000000000000
000000000000000
000000000000000
000000000000000
000222000020000
000002000020000
000000000020000
111000000020000
111000000000000
111000000000000
