000000022000111
000000020000111
000000020000111
000200000000002
000200000000000
000000000000000
000000000020000
000000000020000
222200000002000
200000000002000
200000000000000
000000000000000
000000000000000
000000000000222
000222000000000
000020000000000
000000000000000
111000000022000
111000000022000
111000000022000
